0000000000000000000000000000
0000000000000000000000000000
1111111111111111111111111111
1222222222222112222222222221
1211112111112112111112111121
1311112111112112111112111131
1211112111112112111112111121
1222222222222222222222222221
1211112112111111112112111121
1211112112111111112112111121
1222222112222112222112222221
1111112111112112111112111111
0000012111112112111112100000
0000012112222222222112100000
0000012112111441112112100000
1111112112144444412112111111
2222222222144444412222222222
1111112112144444412112111111
0000012112111111112112100000
0000012112222222222112100000
0000012112111111112112100000
1111112112111111112112111111
1222222222222112222222222221
1211112111112112111112111121
1211112111112112111112111121
1322112222222052222222112231
1112112112111111112112112111
1112112112111111112112112111
1222222112222112222112222221
1211111111112112111111111121
1211111111112112111111111121
1222222222222222222222222221
1111111111111111111111111111
0000000000000000000000000000
0000000000000000000000000000